// SCNAME<tab>ICONNAME
FOODAGI	agi_gogi
FOOD_AGI_CASH	agi_gogi
AKAITSUKI	akaitsuki
// aspdcash
CRITICALWOUND	criticalwound
LIFEINSURANCE	death
FOODDEX	dex_gogi
MANU_ATK	efst_atk
SPL_ATK	efst_atk
MANU_DEF	efst_def
SPL_DEF	efst_def
MANU_MATK	efst_matk
SPL_MATK	efst_matk
RETURN_TO_ELDICASTES	eldicastes
EXPBOOST	exp
EXTREMITYFIST	extremityfist
NOT_EXTREMITYFIST	extremityfist
FROSTMISTY	frostmisty
GENSOU	gensou
// gogi	// Red food without title
ODINS_POWER	all_odins_power
CLOSECONFINE	i_closeconfine		
ACCURACY	i_accuracy
ADJUSTMENT	i_adjustment
BUNSINJYUTSU	i_bunsin
READYCOUNTER	i_counter
COUNTER_READY	i_counter
DODGE	i_dodge
DODGE_READY	i_dodge
DOWNKICK_READY	i_downkick
GATLINGFEVER	i_fever
KAAHI	i_kaahi
KAIZEL	i_kaizel
KAUPE	i_kaupe
MADNESSCANCEL	i_madness
// i_maemi
MOON_COMFORT	i_mooncomfort
NEN	i_nen
ONEHAND	i_onehand
// i_p_dark
// i_p_earth
// i_p_fire
// i_p_saint
// i_p_tele
// i_p_water
// i_p_wind
// i_resist_cold
// i_resist_earth
// i_resist_fire
// i_resist_thunder
RUN	i_run
SHRINK	i_shrink
SIGHTBLASTER	i_sightblaster
STAR_COMFORT	i_starcomfort
STORMKICK_READY	i_stormkick
SUN_COMFORT	i_suncomfort
TURNKICK_READY	i_turnkick
DOUBLECAST	i_더블캐스팅
// i_오버맥스	// Prefatio?
LANDENDOW	i_장판	// Sage floor casts
// i_체이스힘	// Yellow fist
EDP	i_치독
TAROT i_타로카드
// i_프리저브 // Pink-white human and 2 lines
MARIONETTE	icon01
MARIONETTE2	icon01
MAGICPOWER	icon02
//	icon03	// Red hammer in a star, some mastersmith cast
//	icon04	// Yellow icon: moving sword.
ASSUMPTIO	icon05
ASSUMPTIO_2	icon05
WINDWALK	icon06
CARTBOOST	icon07
TENSIONRELAX	icon08
TRUESIGHT	icon09
// icon10	// Light blue - crossed swords
FOODINT	int_gogi
FOOD_INT_CASH	int_gogi
ITEMBOOST	item
IZAYOI	izayoi
CASH_PLUSONLYJOBEXP	job
REWARD_PLUSONLYJOBEXP	job
KAGEMUSYA	kagemusya
KG_KAGEHUMI	kg_kagehumi
KYOMU	kyomu
BANDING	lg_banding
